Agkistrodon contortrix : Eastern Copperhead
Agkistrodon piscivorus : Northern Cottonmouth
Crotalus atrox : Western Diamond-backed Rattlesnake
Crotalus horridus : Timber Rattlesnake
Sistrurus miliarius streckeri : Western Pygmy Rattlesnake
Micrurus tener : Texas Coralsnake
Liodytes rigida sinicola : Gulf Swampsnake
Nerodia cyclopion : Mississippi Green Watersnake
Nerodia erythrogaster transversa : Yellow-bellied Watersnake
Nerodia fasciata confluens : Broad-banded Watersnake
Nerodia rhombifer rhombifer : Northern Diamond-backed Watersnake
Nerodia sipedon pleuralis : Midland Watersnake
Regina grahamii : Graham’s Crawfish Snake
Regina septemvittata : Queensnake
Storeria dekayi : Dekay’s Brownsnake
Storeria occipitomaculata : Red-bellied Snake
Thamnophis proximus proximus : Orange-striped Ribbonsnake
Thamnophis sirtalis sirtalis : Eastern Gartersnake
Tropidoclonion lineatum : Lined Snake
Virginia striatula : Rough Earthsnake
Virginia valeriae elegans : Western Smooth Earthsnake
Carphophis amoenus helenae : Midwestern Wormsnake
Carphophis vermis : Western Wormsnake
Diadophis punctatus ssp : Ring-necked Snake
Farancia abacura reinwardtii : Western Mudsnake
Heterodon platirhinos : Eastern Hog-nosed Snake
Cemophora coccinea copei : Northern Scarletsnake
Coluber constrictor ssp : North American Racer
Lampropeltis calligaster : Prairie Kingsnake
Lampropeltis gentilis – L. triangulum : Milksnake complex
Lampropeltis holbrooki : Speckled Kingsnake
Masticophis flagellum flagellum : Eastern Coachwhip
Opheodrys aestivus : Northern Rough Greensnake
Pantherophis emoryi – P. slowinskii : Great Plains / Slowinski’s Ratsnake complex
Pantherophis obsoletus : Western Ratsnake
Sonora episcopa : Great Plains Groundsnake
Tantilla gracilis : Flat-headed Snake